r 0.5 0 0 4
r 0 1 0 5
r 0 2 0 5
r 0 3 0 5
r 0 4 0 5
r 0.5 5 0 4
r 0 1 1 5
r 0 2 1 5
r 0 3 1 5
r 0 4 1 5